NO ./src/img/N.png
SO ./src/img/S.png
WE ./src/img/W.png
EA ./src/img/E.png
F 128,128,128
C 0,0,0

1111111111111
1001000000001
1000000000001
1N00110000001
1111111111111