
NO ./src/img/N.png
SO ./src/img/S.png
WE ./src/img/W.png
EA ./src/img/E.png
F 128,128,128
C 0,0,0

1111111111111111111111
10000000000000000000S1
1011111111111111111111
1010000000000000000001
1010111111111111111101
1010100000000000000101
1010111111111111110101
1010000000000000000101
1011111111111111111101
1000000000000000000001
1111111111111111111111