NO ./src/img/N.png
SO ./src/img/S.png
WE ./src/img/W.png
EA ./src/img/E.png
F 128,128,128
C 0,0,0

1111111111111111111111111111111111
1000000000000000000000000000000001
1010000000000000000000000000000001
1010010000000000001001000000010101
1E00000000000000000000000000000001
1111111111111111111111111111111111