NO ./src/img/N.png
SO ./src/img/S.png
WE ./src/img/W.png
EA ./src/img/E.png
F 128,128,128
C 0,0,0
        1111111111111111111111111
        1000000000D00000000000001
111111111000000000000000000000001
100000000011000000000000D00011111
111100000000000000000000D0001
110000011100000111110000N0111
11110111 1110101 101111010001
11111111 1111111 111111111111