NO ./src/img/N.png
SO ./src/img/S.png
WE ./src/img/W.png
EA ./src/img/E.png
F 128,128,128
C 0,0,0
        1111111111111111111111111
        1000000000110000000000001
        1011000001110000000000001
        1001000000000000000000001
111111111011000001110000000000001
100000000011000001110111111111111
11110111111111011100000010001
1111011111111101110101001CCC1
1100000011010101110000001CCC1
10000000000000001100000010001
10000000000000001101010010001
11000001110101011111011110N01
110000001101010111000000D0001
1000000000000000D000000010001
10000000000000001101010010001
11000000110101010D00000010001
10000000000000001100000010001
10000000000000000D01010010001
11000000110101011100000010001
10000000000000001100000010001
10000000000000001101010010001
1111011111110101 101111010001
11111111 1111111 111111111111