NO ./../img/icon.png
SO ./../img/icon.png
WE ./../img/icon.png
EA ./../img/icon.png
F 220,100,0
C 225,30,0
        1111111111111111111111111
        1000000000110000000000001
        1011000001110000000000001
        1001000000000000000000001
111111111011000001110000000000001
100000000011000001110111D11111111
11110111111111011100000010001
11110111111111011101010010001
110000001101010111000000D0001
10000000000000000D00000010001
10000000000000001101010010001
11000001110101011111011110N0111
11110111 1110101 101111010001
11111111 1111111 111111111111