NO ./src/img/N.png
SO ./src/img/S.png
WE ./src/img/W.png
EA ./src/img/E.png
F 128,128,128
C 0,0,0
11111111111111111111111111111
1000E000000000000000000000001
10000000000000000000000000001
1P000000000000000000000000001
1000C000000000000000000000001
10000000000000000000000000001
100000000000000000000000000C1
11111111111111111111111111111