NO ./src/img/N.png
SO ./src/img/S.png
WE ./src/img/W.png
EA ./src/img/E.png
F 128,128,128
C 0,0,0

111111111111
1000000000N1
10000N000001
1C0000000001
111111111111