NO ./src/img/N.png
SO ./src/img/S
WE ./src/img/W.png
EA ./src/img/E.png
F 128,128,128
C 0,0,0

11111111111
100000S0101
10101000111
11111111111